XXXXXXXXXXXXXXXXXXXXXXXXXXXXXXXXXXXXXXXXXXXXXXXXXXXXXXXXXXXXXX
XXX                                                        XXX
XXX                                    b                   XXX
XXX                                                        XXX
XXX                                                        XXX
XXX            b                                           XXX
XXX                                                        XXX
XXX       b                                                XXX
XXX                                                        XXX
XXXXXXXXXXXXXXXXXXXeeeXXXXXXXXXXXXXXXXXXXXXXXXXXXXXXXXXXXXXXXX